0000000000000000000000000000000000000000000000000
0222222222000222200222200222200222200222200222200
0211111112000211200211200211200211200211200211200
0211111112222212222212222212222212222212222212222
0211111111111111111111111111111111111111111111112
0211111111111111111111111111111111111111111111112
0222222222222222222222222222222222222222222222222
0000000000000000000000000000000000000000000000000